UUID;net_verhoogd;hoek;larven;metamorf;adult;post_metamorf;totaal
84388f24-dc95-4374-a92b-f991dd19bd34;TRUE;45°;85;1;1;2;87
047079e1-ebf3-4c84-bf43-e787d8b1720c;TRUE;45°;18;6;0;6;24
5db52697-dae8-46b9-8986-bac3b7c47e23;TRUE;45°;15;4;0;4;19
151f1c07-97f7-4e55-84f4-6d11a0eca58f;TRUE;45°;118;21;2;23;141
c2475fb2-12a2-4896-ac50-73668b20eb33;TRUE;45°;114;7;1;8;122
91bbb52d-71ef-4c83-9a4f-14d144f601e8;TRUE;45°;2;1;0;1;3
1846afaa-ec47-41eb-b588-1a7d17e517bf;TRUE;45°;186;1;1;2;188
f39615d2-4861-45cf-9ff9-18ade180fd93;TRUE;00°;0;0;0;0;0
b33081f8-ca1e-4f20-8ba8-e1ece38f3b64;TRUE;00°;0;0;0;0;0
7a114922-aa61-4d04-b54b-703e12fc41af;TRUE;90°;0;0;0;0;0
5003be39-1aa9-41f3-9d0b-8a235347819c;TRUE;00°;0;0;0;0;0
c1e217ab-0c4e-4155-a75a-f979628fb6ad;TRUE;00°;0;0;0;0;0
de2a48cc-a0f0-43f9-a803-ff63f112e362;TRUE;00°;0;0;0;0;0
73efcef1-27a1-413a-9ac8-9a36c0e3bce3;FALSE;00°;0;1;0;1;1
ccb9de65-e436-4404-a451-d101009ed4b9;FALSE;00°;0;0;0;0;0
3134c8d5-69b0-41d1-9006-a8ec5b7ab4c0;TRUE;00°;1;0;0;0;1
d228613d-3c2f-439f-bbdc-caee0361e854;TRUE;00°;47;7;1;8;55
c4b89b3d-6c45-4827-8184-0282f7308e51;TRUE;00°;13;0;0;0;13
041a7043-da05-4122-b36c-e39d58e17a9b;TRUE;00°;0;0;0;0;0
0267c91e-85de-4fbc-a90f-d6951edb9581;TRUE;00°;0;0;0;0;0
babf42c1-4552-43d0-8b96-76b1f699ac22;TRUE;00°;1278;0;3;3;1281
f67df926-3242-41d0-8b89-73a2f3b6ccf5;TRUE;00°;208;3;2;5;213
b5000acc-721e-44af-bdee-39cdcc2a2b8d;TRUE;45°;126;1;1;2;128
dcca02bd-661f-49ca-94e3-485c859c6fc8;TRUE;00°;306;4;0;4;310
334d0bf5-6217-4b71-b09f-29e898cd4d43;TRUE;00°;0;0;0;0;0
79aaae61-28c1-47b9-85bd-9c04a5bf69e2;TRUE;00°;83;2;1;3;86
f25ddbeb-08c3-4a3f-a0c3-b21bb6ab77e0;TRUE;45°;81;2;1;3;84
8dcb98b7-6b6a-4c61-b8de-d8f4c7e57cf0;TRUE;45°;94;1;0;1;95
3f800b82-2da1-4cb9-8706-1ca78e3bb1c8;TRUE;45°;225;2;0;2;227
1ffd87c1-cedf-4cc4-b23a-63c21e4ee89a;FALSE;45°;133;0;0;0;133
999ff59e-dc97-4103-a91a-bec9ad761978;TRUE;00°;0;0;0;0;0
69e57d5e-583f-40c2-9c2f-1aa7abcab7a6;TRUE;00°;0;0;0;0;0
38833b38-7912-4579-a380-3b7fcb4fa408;TRUE;00°;0;0;1;1;1
9a14e48d-64f0-42cc-a802-3159a508c915;FALSE;00°;0;0;0;0;0
59d9c6db-d425-4036-8c2d-5449cac483e3;TRUE;00°;0;0;0;0;0
deff4814-0468-43ec-91b6-c5a9b6d76039;TRUE;00°;0;0;0;0;0
c98e4fd8-d511-447a-bedf-1bd60cbba181;TRUE;00°;0;0;1;1;1
2c1ad831-9205-49e6-88b3-6c7505a6be09;FALSE;00°;0;0;0;0;0
51f194ea-4243-493b-8582-7089fa733f97;TRUE;00°;0;0;0;0;0
d3021af0-c9a5-478c-98ef-229ca891c8b9;TRUE;00°;0;0;0;0;0
13836a1f-8430-4b64-b316-f6ce87a989f4;FALSE;00°;0;0;0;0;0
a17d21f4-4ffd-429d-a371-d84bbced2e3f;FALSE;00°;0;1;0;1;1
77030965-00fa-47c5-9425-0217c2caa97f;TRUE;00°;0;0;0;0;0
1c533fba-47a8-4e1c-9e74-567f95246b49;TRUE;00°;0;0;0;0;0
469972e8-ecde-4136-811b-1b5c4db9aa7b;TRUE;00°;0;1;0;1;1
bcf1de11-5f1a-41b6-9cee-4881bbcbba9a;FALSE;00°;0;0;0;0;0
ecb8e09e-7496-4024-91ec-ace91d8183e7;TRUE;00°;0;0;0;0;0
731435fd-ad41-4595-9d55-f42775792da4;TRUE;00°;0;0;0;0;0
c6788015-ddf8-4b04-b2a0-8655fcbceb4d;TRUE;00°;0;0;2;2;2
378cbf1c-3887-437c-b7a9-44d40a693367;FALSE;00°;0;0;0;0;0
964ecb87-ddb8-4316-b6f8-eadb01de98ef;TRUE;00°;0;0;0;0;0
d49311ee-95e5-430f-a88f-bbafeabd28ff;TRUE;00°;0;0;0;0;0
acdb92e8-f964-4178-afb4-74156f325159;TRUE;45°;0;0;0;0;0
3d240393-383d-47fc-857a-dad4886cce8e;TRUE;45°;0;0;0;0;0
3d3d84fd-728e-47c9-914d-da97ec3b99aa;TRUE;00°;0;0;0;0;0
1093a6cc-3ed9-4912-b5a2-23ab13cb56ca;TRUE;00°;0;0;0;0;0
7131411c-ba46-4788-af91-020f742a2925;TRUE;00°;0;0;0;0;0
c04fab4e-b599-4b8c-829d-e790306a2743;TRUE;00°;0;0;0;0;0
9394bb43-8168-45bc-99a2-761320330fd5;TRUE;00°;0;0;0;0;0
f11a7093-df59-48bb-9449-56e8f4955679;FALSE;00°;0;0;0;0;0
6f787ca8-c926-406f-9829-266359d1c1d2;FALSE;00°;0;0;0;0;0
cb0b0501-7746-402f-9e27-e2700f7618d5;FALSE;00°;0;0;0;0;0
cd2b1bc1-ebdf-4c65-8504-b3350ef64137;TRUE;00°;0;0;0;0;0
271a5d04-0483-427f-b809-4396cc0801fc;TRUE;00°;0;1;1;2;2
e427ea76-8adc-4a4c-b33d-ca91d2cad441;FALSE;00°;0;0;0;0;0
84731a8f-c315-4d7f-b6a8-3105993dc443;FALSE;00°;0;1;0;1;1
8ef34315-2d99-4804-a0b1-e6b5721cf213;FALSE;00°;0;0;0;0;0
742aa005-8b42-47a2-bdee-129a68190462;FALSE;00°;0;0;0;0;0
0888e4b1-e5d4-4b2c-ac16-0382a5bdf864;FALSE;00°;590;75;0;75;665
5065c6cf-7043-4c1d-9c72-f5b98d215e28;FALSE;00°;20;9;0;9;29
0d45baef-28d7-4778-ae33-edb2d5d25e12;FALSE;45°;0;0;0;0;0
ab180706-2056-4f83-9e76-d37fcc59bf2c;FALSE;45°;0;5;0;5;5
cb77f7b5-ccee-4fe2-a072-21ba7f7a983f;FALSE;45°;0;0;0;0;0
18be1861-b28a-4d76-98c9-13941999491c;TRUE;00°;0;0;0;0;0
60d770fc-6179-4abf-ade4-9923dcad8195;TRUE;00°;0;0;0;0;0
af2f46aa-326e-4414-9b30-a29cbdf84f84;TRUE;00°;0;0;0;0;0
211fc2c6-526d-47be-9163-67c7dd6a15a4;TRUE;00°;0;0;0;0;0
8453c038-09bd-4f72-90f6-492eb0fc5b74;TRUE;00°;0;0;0;0;0
84c461af-d0b3-4817-9dc6-c525c6494b56;TRUE;00°;0;0;0;0;0
c844ec6f-8cfc-4ced-a52d-d625ed745023;FALSE;45°;0;0;0;0;0
557e10fe-4314-4e3b-92e0-296bdc4f9358;FALSE;45°;0;0;0;0;0
6967b568-9824-4048-a72f-5d78d2197065;FALSE;45°;0;3;0;3;3
dd5d23e7-0510-4f55-a22a-47a2104830bb;FALSE;45°;0;0;0;0;0
86f25eff-9411-4700-b78b-938326cf8793;FALSE;45°;0;0;0;0;0
0fe88942-86a1-43d2-9579-c8e75c0a6dfc;FALSE;45°;0;0;0;0;0
d5eb0ff6-3640-4c27-9570-78a5a363706a;FALSE;45°;4;0;2;2;6
75a3d771-5a2d-46df-bbdc-d4ae110ad410;FALSE;45°;0;0;0;0;0
3616a9ef-47bb-441f-aa45-e03a5fd8e0ee;FALSE;45°;0;0;0;0;0
76730a00-9a4c-4c87-bf3f-104b65db0049;FALSE;45°;0;0;0;0;0
1c2bc8ab-08c6-4e36-bfc4-905e5ca14d72;FALSE;45°;0;4;0;4;4
126aac58-4fdb-4b6e-a33e-0a44cda779f0;FALSE;00°;0;0;0;0;0
fd2dc46b-e844-4bac-8780-242832f63f9c;FALSE;00°;0;0;0;0;0
fd73511f-730c-4685-92d0-ceaf3b986fc5;FALSE;45°;0;0;0;0;0
59aa5c7d-edc6-4edd-80d1-e99a81746342;FALSE;00°;0;0;0;0;0
cdeaa837-3caa-4f27-ba55-d5ea6e0f735c;FALSE;00°;0;0;0;0;0
330f7a3c-41cd-4d60-a91c-17d4c06b533c;NA;45°;0;0;0;0;0
0db6bf16-2dca-4e02-b348-37a2d13300ce;FALSE;45°;0;0;0;0;0
56683e42-0484-4eae-a205-43b6454ae086;FALSE;00°;0;0;0;0;0
66c1cef7-ef32-44be-859f-632ef5b0dc64;TRUE;00°;0;3;0;3;3
911a7b1f-41fa-4827-a2b7-7d4f6a3e2192;TRUE;45°;0;3;0;3;3
b9f4655c-3f46-47e6-9fd9-003ae2740344;TRUE;00°;0;1;0;1;1
bba2543a-8c11-4410-a9c5-b5bd22e0b4a5;TRUE;00°;0;1;0;1;1
87e6452a-4117-405a-a861-d389fa18c1cb;NA;45°;0;1;0;1;1
98008afc-db9d-41f4-9666-d9f3e1cc6563;FALSE;00°;0;0;0;0;0
d7057ed7-83fd-4774-9245-35fd1fe20ff6;FALSE;00°;0;0;0;0;0
e1e7ab81-7518-4e7e-8bfb-d1272197909a;TRUE;00°;0;2;0;2;2
7d47e43d-0f45-4fee-bbf9-2aab9b17f797;TRUE;00°;0;0;0;0;0
545c798e-514b-4fdc-a3e9-e16f9252c036;TRUE;00°;0;0;0;0;0
f5431483-cddf-4f34-a0a2-73e76134f630;TRUE;00°;0;0;0;0;0
c645f2b9-255b-4dc4-bcb6-d21b87b7270f;TRUE;00°;0;0;0;0;0
fba08b0f-5607-49d1-8543-e509087c0330;TRUE;00°;0;0;0;0;0
de0c7388-1a8b-4f3f-a97e-de0f4b5e41d0;TRUE;00°;0;7;0;7;7
409da35c-1143-4f72-8599-3df0675db3fd;TRUE;00°;0;2;0;2;2
e1258f18-5356-4587-9b6b-a58d21e1d33f;TRUE;00°;0;0;0;0;0
0a84388f-62e0-492f-9505-a871affd1c0e;TRUE;00°;0;0;0;0;0
79b6f745-f5e3-4fce-bd50-6e96a6a03994;TRUE;45°;0;2;0;2;2
c7bd2e40-86da-4cab-a8e0-669beaa93e0b;TRUE;45°;0;1;1;2;2
b9d55f5d-f34e-4ae1-894e-685477314c71;TRUE;00°;0;0;0;0;0
16b340d7-f2ac-4a84-957c-36029a53f577;TRUE;00°;0;0;0;0;0
46919f62-1c3a-4fe8-ac4b-7c2e2cd416de;TRUE;00°;0;1;0;1;1
4c1da717-9ed2-4e9d-9fbd-0798aee168fd;TRUE;45°;0;0;0;0;0
a3db5489-9361-4bd3-b49b-959296514fd3;TRUE;00°;0;0;0;0;0
2aded18d-e167-4d8c-924c-7401862fef81;TRUE;00°;0;0;0;0;0
266dcc06-d5d2-4af9-bb37-90d31cff8e4b;TRUE;90°;0;0;0;0;0
bd2ae319-9a42-405d-9a45-64df6f97116d;TRUE;00°;0;0;0;0;0
1f658401-df53-46ae-9f33-55b6b2512591;TRUE;00°;0;0;0;0;0
4d53ee07-9863-4991-bd88-4099bfd01449;TRUE;00°;0;0;0;0;0
3f5e0773-d384-4d63-8326-037e0d3d4eea;TRUE;00°;0;0;0;0;0
9e19d3f9-67d1-4ff0-ad1f-989a2ecf5fc3;TRUE;45°;0;0;0;0;0
60c845b7-6ee6-4b40-a26a-507f44837a4d;TRUE;00°;0;0;0;0;0
85d69f8e-ac25-445d-a5b9-88f891633c13;TRUE;00°;0;1;0;1;1
62f55315-1916-41ba-a05d-ce5c839d8e94;TRUE;00°;0;0;0;0;0
be7d7432-259e-4ddc-ad2e-9a13f05b36d9;TRUE;00°;0;0;0;0;0
35ee06af-175d-4439-9e38-37c79436eefc;TRUE;00°;0;0;0;0;0
a8adcc93-28b7-4736-b225-894d70bc0b1f;TRUE;00°;0;8;0;8;8
1e445768-bb1c-4a2c-b275-6344cc59fe43;TRUE;45°;0;2;0;2;2
5cc61c19-78ba-4b74-89c9-127f0734b557;TRUE;45°;0;1;0;1;1
5504e3d7-fa02-4971-89fa-712bbe839175;TRUE;45°;0;6;0;6;6
f093d575-8fcf-4981-8fe0-99c60d264996;TRUE;00°;0;0;0;0;0
1f539632-09c8-4e34-a654-2556cc540314;TRUE;45°;0;1;0;1;1
27f2826d-caa4-43de-abcd-10f80227caf7;TRUE;00°;0;0;0;0;0
9019cc6a-9deb-4654-99f4-07dd6b342649;TRUE;00°;0;0;0;0;0
6b08da2b-39b8-40e2-b729-3ac8a557fa47;TRUE;00°;0;0;0;0;0
f33ccbbd-5ff3-4c80-88f1-8592f22c655a;TRUE;00°;0;0;0;0;0
1b4fb706-fc9b-41b5-b168-d46aba610231;TRUE;00°;0;0;1;1;1
5bc742e3-13fb-4622-a4e3-684b0ea9667a;TRUE;00°;0;0;1;1;1
44a74713-1397-47eb-8b9a-29717df6bdef;TRUE;00°;0;0;0;0;0
f993d219-fa3d-4300-acc0-fb459b38f079;TRUE;00°;0;0;0;0;0
5ebb7973-d420-4496-83f7-e8b6ec72ed20;TRUE;00°;0;0;1;1;1
786a960d-5c53-4397-8499-f6d4b9319de6;TRUE;45°;0;10;0;10;10
0e0ea1c7-e6ef-47ec-9a30-4fcfeaa94fcf;FALSE;00°;0;1;0;1;1
a1bc5173-b872-4732-ae5c-00f33e828a61;TRUE;45°;8;0;0;0;8
2e32bb6a-cb04-4355-96ce-03b1a983ecef;FALSE;00°;0;0;0;0;0
f76d48ad-de19-4df1-8cc7-a75726e98a9e;FALSE;00°;0;0;0;0;0
4e6949e7-9205-4c85-badf-229d6cc96e81;FALSE;00°;0;0;0;0;0
aa51b5f9-d75a-4f16-b1d6-89f1f38f6afb;FALSE;90°;0;0;0;0;0
0a84f911-21ed-45f5-87d9-27c16d31439e;FALSE;90°;0;0;0;0;0
2ff8e510-5849-479b-8f39-46f84123abff;FALSE;00°;0;0;0;0;0
9bf07d07-3a48-4867-a8f6-662ecd038a7c;FALSE;00°;0;0;0;0;0
1034446f-092e-4df7-b79d-24c5c1bf6685;FALSE;00°;0;0;0;0;0
16f6d9a5-2fa6-43e7-838b-2698076278af;FALSE;00°;0;0;0;0;0
5cb2e832-768f-45b3-b50f-6e68cb9f9f29;TRUE;00°;35;0;0;0;35
724d0488-339b-4e91-aec3-fa58357224c9;TRUE;00°;0;0;0;0;0
d61f33f4-bf8a-4c8f-b90d-eb2ce3c978db;FALSE;45°;0;0;0;0;0
0f4dc010-451e-4e16-8689-8007c9dc5cb1;FALSE;00°;0;0;0;0;0
857080ab-eb23-4922-a4a7-0624bb13de62;TRUE;00°;0;0;0;0;0
6e713425-c180-44ca-ac54-6d057f274e96;TRUE;00°;0;0;0;0;0
e9e887dc-b23b-4d13-bc89-350b02a8a4cc;TRUE;00°;0;0;0;0;0
1785dee8-4d16-43e4-a5d4-65befc925df6;TRUE;00°;0;0;0;0;0
8d19c6f2-9c65-4747-b5e7-2984f5ed49a1;TRUE;00°;0;0;0;0;0
92457e18-241b-4725-8841-4627478ad06a;TRUE;00°;0;0;0;0;0
2155de65-a7ce-4a1d-974c-e3fe39bb628f;TRUE;00°;0;0;0;0;0
bf42390a-4fee-4364-900a-7a70c3e88818;TRUE;00°;0;0;0;0;0
890d061d-fbf1-4f4b-941b-2ea57e65131b;TRUE;00°;0;0;0;0;0
5451bfb7-9e34-4afa-8d94-c575abdffd8a;TRUE;45°;0;0;0;0;0
76c343e5-1829-446a-91e0-8a0bdfbce62a;TRUE;00°;0;0;0;0;0
da387f7b-5184-4d39-86a3-3cf918e67cdf;TRUE;00°;0;0;0;0;0
6615b3fe-46ca-4bb1-b3bd-38acdd8013b3;TRUE;00°;0;0;0;0;0
6cf272af-f2bc-4919-b0c5-ba55b972b9dc;TRUE;00°;0;0;0;0;0
173f08c5-6a91-4a80-a5ea-7c23b78adafa;TRUE;00°;0;0;0;0;0
f07649a7-b055-4a5f-9132-f938fe95cf62;TRUE;00°;0;4;0;4;4
9668f6d1-5e77-4bf5-8c15-461ef99b2691;TRUE;00°;121;0;0;0;121
c7ef29a7-5e4e-4346-ba2f-a33d796ce2bc;TRUE;00°;62;0;0;0;62
7d05f02e-195a-4e96-a600-550da0e936bb;TRUE;00°;0;0;0;0;0
fd165451-471e-49c3-9933-e91b94f142bf;TRUE;00°;2;2;0;2;4
c37ce59e-47ce-4869-a78d-edf05f4465d7;TRUE;00°;0;0;0;0;0
a6454f46-2389-4636-9722-74c6bbeefe5b;TRUE;00°;0;0;0;0;0
36f53d3b-5b15-4fad-83ad-a6cf80cb67b4;TRUE;00°;0;0;0;0;0
76e7bd6e-21b7-4f91-9d05-c05a437e9786;TRUE;00°;0;0;0;0;0
2b3a871b-5a98-4d4c-823a-d5547738c135;TRUE;00°;0;0;0;0;0
ad70f6d7-129e-411c-acb0-5fd4373f012c;TRUE;00°;3;0;0;0;3
5adb3eb7-8bb4-4c1e-92b7-03d00f7e6de1;TRUE;00°;0;0;0;0;0
1ea6b3e8-92e8-4839-8ae6-bcff38f2539d;TRUE;00°;19;0;0;0;19
ca221ccd-bcce-447d-9f8a-30c55655c779;TRUE;00°;8;0;0;0;8
e337d88f-1932-438c-9ad9-57321277c62b;TRUE;00°;8;0;0;0;8
c7cc418b-9385-44c6-888a-27db4052e30d;TRUE;00°;20;0;0;0;20
80deb14e-11ec-4160-be71-ee6aede8fdca;TRUE;00°;1;2;0;2;3
3d2a34bd-fb1f-4e51-af5a-8a9efcf5ced0;TRUE;00°;5;1;0;1;6
7f875f72-4d40-4be2-999e-fd48e01eae5c;TRUE;45°;117;0;5;5;122
544d0a0d-d6d6-4114-858a-98ad2e7d3b67;TRUE;45°;22;1;3;4;26
354580a0-a7cf-4b18-9817-90781545b558;TRUE;45°;13;0;0;0;13
cae973f9-16fe-46dc-b399-936856af8582;TRUE;45°;20;0;0;0;20
ccb7ea22-a82f-4a35-9d5c-f7aafab25c70;TRUE;45°;32;0;1;1;33
36ddfbfb-a80c-41d5-8e12-cf610da64914;TRUE;45°;104;0;3;3;107
f7eb7228-dd62-4ea3-9cd6-38088bfed039;TRUE;45°;31;0;0;0;31
2f833366-78f2-4435-969a-0305bced4a9b;TRUE;45°;32;1;0;1;33
8b4c30f5-c96b-4345-befa-f1c6587bc6b0;TRUE;45°;151;0;3;3;154
70efec6e-0750-4760-9a74-6fb24825f48f;TRUE;00°;21;0;3;3;24
e860b1c9-5f69-48c6-8300-74735cab6c76;TRUE;45°;35;0;2;2;37
5662f00d-8bd2-43d1-97ac-c77050a6a070;TRUE;45°;1;1;0;1;2
74a076b7-529d-4630-95e2-496ad1a20ace;TRUE;45°;14;0;0;0;14
ab091f02-2beb-49b2-90df-708443304af2;TRUE;45°;10;0;0;0;10
d407b112-869f-497b-ad8a-5ab6611d0f5f;FALSE;45°;84;0;0;0;84
be44e585-c37e-4d68-936e-ca7ba6b5a80c;TRUE;00°;14;0;0;0;14
259d5cfa-5e74-41e1-88a2-a70590ac544e;TRUE;45°;50;0;0;0;50
961671a6-bc4a-4f50-9eaf-c9dfc0167ff8;TRUE;45°;15;0;0;0;15
a5ff9d7f-a67b-4e0f-8193-dcaaa7d86af7;TRUE;45°;16;0;0;0;16
80f9ca90-5afa-4f78-a93a-3866ae739e49;TRUE;45°;1137;1;0;1;1138
26bf5f72-fec3-42d3-b42c-737c15683920;TRUE;45°;1;0;0;0;1
e05e3dd8-0c6d-4cba-ba53-01fc6f9f974e;TRUE;45°;4;0;0;0;4
4d666e53-1e9a-4a75-bee1-b776ba20e3b9;TRUE;45°;8;0;0;0;8
533cf4e4-a8fb-4b34-809f-86a46802a4dc;TRUE;45°;36;0;0;0;36
0a86adaa-0a8f-449a-a157-8ba7c48f09cc;TRUE;45°;295;0;0;0;295
18b5e0ca-460a-4a2c-9dd9-6df2c9f95467;TRUE;00°;0;0;0;0;0
5ac33bb3-6a71-452f-a00d-335d96201008;TRUE;00°;0;0;0;0;0
265056f3-be45-4028-a676-e28af0fa6535;TRUE;00°;0;0;0;0;0
6964f879-9a5a-4a83-8267-d5b5177cb6e6;FALSE;90°;0;0;0;0;0
526cba43-e455-401d-8fca-ca768ed8efce;FALSE;00°;0;0;0;0;0
45e82ac5-d5f5-4ebc-b992-678c3919b4aa;TRUE;00°;0;0;0;0;0
f04d6477-af92-4df4-aa14-9b7baf4f082b;TRUE;90°;0;0;0;0;0
2e0c63a3-4c0e-48ea-8560-fff7773005c0;TRUE;00°;0;0;0;0;0
708fea48-92d2-4044-8693-96bc7df6c71c;TRUE;00°;9;0;0;0;9
1e98aa97-cf6a-4be4-953e-eb07be7b96b2;TRUE;90°;1;0;0;0;1
011baa9a-18e8-42db-9547-29cd4445ff89;TRUE;45°;23;0;0;0;23
e1876fd1-e991-4032-9958-fc7e27bbb30f;TRUE;45°;22;0;1;1;23
94e942da-6a95-44a1-a0ca-a758ae266c83;TRUE;45°;3;0;0;0;3
5c4420b3-c459-4f1e-93e5-34bffc8094ae;TRUE;45°;273;0;2;2;275
2c7a14c9-e4c8-4e4d-902c-d941c4eb89e7;TRUE;00°;7;0;0;0;7
fbd31585-9e1c-4ef8-95a4-335955ddae9a;TRUE;45°;7;0;0;0;7
bf67fcdf-d77c-4e77-9cb1-13b4163ac662;TRUE;00°;19;0;1;1;20
aa8b9db9-eeb0-44da-a05d-53a1c17998a0;TRUE;45°;1;0;1;1;2
e1884a8d-f24e-4e65-a699-9a0b8b8172ca;TRUE;00°;26;0;1;1;27
6b4ee311-d736-4a31-a9ba-6f039261414e;TRUE;45°;50;0;0;0;50
4f3b1cba-0cef-486d-8392-799c26c233aa;TRUE;00°;118;0;0;0;118
9ed5adb1-d086-4521-a1d8-5cbd2e435450;TRUE;45°;29;0;0;0;29
254a0167-31b0-4208-bc7f-d11c9b24c3c0;TRUE;45°;3;0;0;0;3
17a6a8ec-fa65-427a-8663-4947031396ce;TRUE;00°;24;0;1;1;25
d2193f18-7b75-47ba-9711-58016b8c06ba;TRUE;45°;123;0;0;0;123
8d46aa56-db62-4160-b767-463ff716f261;TRUE;45°;16;0;0;0;16
8701e2d1-4956-4608-981d-c3b938f7cd6b;TRUE;45°;80;1;0;1;81
57e93a29-0129-4d03-bb39-94cf94a67328;TRUE;45°;1;0;0;0;1
1abd7648-ed9a-4103-9a3c-03d10e1ec21f;NA;45°;7;0;0;0;7
cd8ea921-fe97-4f79-8c0e-2965248dba89;TRUE;45°;28;1;1;2;30
afad2798-ad7a-4e07-ab0c-705bc5c3297c;TRUE;45°;12;0;0;0;12
8fac59c4-20d2-4f4b-b7d0-ea078d6d4e7b;TRUE;45°;4;0;0;0;4
cfb60c85-8873-4590-9421-6276fce6456b;TRUE;45°;39;1;0;1;40
18cc60b6-00f1-472a-9bfc-bf257e06e624;TRUE;45°;4;0;1;1;5
a911c8f5-2614-42b9-8643-48fd18cab808;TRUE;45°;0;0;0;0;0
5b89dff1-00d6-471e-b86c-1d917d62c483;TRUE;45°;79;0;1;1;80
85e10418-9220-4c3a-af69-9e9fcea1a069;TRUE;45°;12;0;0;0;12
09d477da-493a-4f00-aadd-2826dc80c228;TRUE;45°;27;0;0;0;27
54fd74a0-4e6d-4953-af30-5f6f936f9a97;TRUE;45°;58;0;0;0;58
af61d329-1809-43ab-9d3c-6e78bd4676e2;TRUE;00°;0;0;0;0;0
24412660-4b37-4bbb-81a3-64485a5ee50b;TRUE;00°;0;0;0;0;0
90f11dab-64ea-465e-aa7c-7dbd7e31fa38;TRUE;45°;0;0;0;0;0
84388f24-dc95-4374-a92b-f991dd19bd34;TRUE;45°;67;0;0;0;67
047079e1-ebf3-4c84-bf43-e787d8b1720c;TRUE;45°;25;5;0;5;30
5db52697-dae8-46b9-8986-bac3b7c47e23;TRUE;45°;13;2;0;2;15
151f1c07-97f7-4e55-84f4-6d11a0eca58f;TRUE;45°;601;58;0;58;659
c2475fb2-12a2-4896-ac50-73668b20eb33;TRUE;45°;156;17;2;19;175
91bbb52d-71ef-4c83-9a4f-14d144f601e8;TRUE;45°;8;1;0;1;9
1846afaa-ec47-41eb-b588-1a7d17e517bf;TRUE;45°;189;0;1;1;190
f39615d2-4861-45cf-9ff9-18ade180fd93;TRUE;00°;0;0;0;0;0
b33081f8-ca1e-4f20-8ba8-e1ece38f3b64;TRUE;00°;0;0;0;0;0
5003be39-1aa9-41f3-9d0b-8a235347819c;TRUE;00°;0;0;0;0;0
c1e217ab-0c4e-4155-a75a-f979628fb6ad;TRUE;00°;0;0;1;1;1
de2a48cc-a0f0-43f9-a803-ff63f112e362;TRUE;00°;0;0;1;1;1
ccb9de65-e436-4404-a451-d101009ed4b9;FALSE;00°;0;0;0;0;0
d228613d-3c2f-439f-bbdc-caee0361e854;TRUE;00°;66;17;0;17;83
c4b89b3d-6c45-4827-8184-0282f7308e51;TRUE;00°;19;3;0;3;22
041a7043-da05-4122-b36c-e39d58e17a9b;TRUE;00°;0;0;0;0;0
0267c91e-85de-4fbc-a90f-d6951edb9581;TRUE;00°;0;1;0;1;1
babf42c1-4552-43d0-8b96-76b1f699ac22;TRUE;00°;990;0;0;0;990
f67df926-3242-41d0-8b89-73a2f3b6ccf5;TRUE;00°;979;0;2;2;981
b5000acc-721e-44af-bdee-39cdcc2a2b8d;TRUE;00°;135;2;0;2;137
dcca02bd-661f-49ca-94e3-485c859c6fc8;TRUE;00°;677;3;0;3;680
334d0bf5-6217-4b71-b09f-29e898cd4d43;TRUE;00°;0;0;0;0;0
79aaae61-28c1-47b9-85bd-9c04a5bf69e2;TRUE;00°;100;5;0;5;105
69e57d5e-583f-40c2-9c2f-1aa7abcab7a6;TRUE;00°;0;0;0;0;0
38833b38-7912-4579-a380-3b7fcb4fa408;TRUE;00°;0;0;0;0;0
9a14e48d-64f0-42cc-a802-3159a508c915;FALSE;00°;0;0;1;1;1
59d9c6db-d425-4036-8c2d-5449cac483e3;TRUE;00°;0;0;0;0;0
c98e4fd8-d511-447a-bedf-1bd60cbba181;TRUE;00°;0;0;0;0;0
2c1ad831-9205-49e6-88b3-6c7505a6be09;FALSE;00°;0;0;1;1;1
51f194ea-4243-493b-8582-7089fa733f97;TRUE;00°;0;0;0;0;0
77030965-00fa-47c5-9425-0217c2caa97f;TRUE;00°;0;0;0;0;0
469972e8-ecde-4136-811b-1b5c4db9aa7b;TRUE;00°;0;2;0;2;2
bcf1de11-5f1a-41b6-9cee-4881bbcbba9a;FALSE;00°;0;1;0;1;1
ecb8e09e-7496-4024-91ec-ace91d8183e7;TRUE;00°;0;0;0;0;0
c6788015-ddf8-4b04-b2a0-8655fcbceb4d;TRUE;00°;0;0;0;0;0
378cbf1c-3887-437c-b7a9-44d40a693367;FALSE;00°;0;0;0;0;0
964ecb87-ddb8-4316-b6f8-eadb01de98ef;TRUE;00°;0;0;0;0;0
d49311ee-95e5-430f-a88f-bbafeabd28ff;TRUE;00°;0;0;0;0;0
acdb92e8-f964-4178-afb4-74156f325159;TRUE;45°;0;0;0;0;0
3d240393-383d-47fc-857a-dad4886cce8e;TRUE;45°;0;0;0;0;0
3d3d84fd-728e-47c9-914d-da97ec3b99aa;TRUE;00°;0;0;0;0;0
1093a6cc-3ed9-4912-b5a2-23ab13cb56ca;TRUE;00°;0;0;0;0;0
7131411c-ba46-4788-af91-020f742a2925;TRUE;00°;0;0;0;0;0
c04fab4e-b599-4b8c-829d-e790306a2743;TRUE;00°;0;0;0;0;0
9394bb43-8168-45bc-99a2-761320330fd5;TRUE;00°;0;0;0;0;0
cd2b1bc1-ebdf-4c65-8504-b3350ef64137;TRUE;00°;0;0;1;1;1
0888e4b1-e5d4-4b2c-ac16-0382a5bdf864;FALSE;00°;1267;96;0;96;1363
0d45baef-28d7-4778-ae33-edb2d5d25e12;FALSE;45°;0;0;0;0;0
cb77f7b5-ccee-4fe2-a072-21ba7f7a983f;FALSE;45°;0;0;0;0;0
18be1861-b28a-4d76-98c9-13941999491c;TRUE;00°;0;0;0;0;0
60d770fc-6179-4abf-ade4-9923dcad8195;TRUE;00°;0;0;0;0;0
211fc2c6-526d-47be-9163-67c7dd6a15a4;TRUE;00°;0;0;0;0;0
84c461af-d0b3-4817-9dc6-c525c6494b56;TRUE;00°;0;0;0;0;0
c844ec6f-8cfc-4ced-a52d-d625ed745023;FALSE;45°;0;0;0;0;0
557e10fe-4314-4e3b-92e0-296bdc4f9358;FALSE;45°;0;0;0;0;0
dd5d23e7-0510-4f55-a22a-47a2104830bb;FALSE;45°;0;0;0;0;0
86f25eff-9411-4700-b78b-938326cf8793;FALSE;45°;0;0;0;0;0
0fe88942-86a1-43d2-9579-c8e75c0a6dfc;FALSE;45°;0;0;0;0;0
75a3d771-5a2d-46df-bbdc-d4ae110ad410;FALSE;45°;0;0;0;0;0
3616a9ef-47bb-441f-aa45-e03a5fd8e0ee;FALSE;45°;0;0;0;0;0
76730a00-9a4c-4c87-bf3f-104b65db0049;FALSE;45°;0;0;0;0;0
fd73511f-730c-4685-92d0-ceaf3b986fc5;FALSE;45°;0;0;0;0;0
330f7a3c-41cd-4d60-a91c-17d4c06b533c;NA;45°;0;0;0;0;0
0db6bf16-2dca-4e02-b348-37a2d13300ce;FALSE;45°;0;0;0;0;0
66c1cef7-ef32-44be-859f-632ef5b0dc64;TRUE;00°;0;3;0;3;3
911a7b1f-41fa-4827-a2b7-7d4f6a3e2192;TRUE;00°;0;4;0;4;4
bba2543a-8c11-4410-a9c5-b5bd22e0b4a5;TRUE;00°;0;1;0;1;1
98008afc-db9d-41f4-9666-d9f3e1cc6563;FALSE;00°;0;0;0;0;0
d7057ed7-83fd-4774-9245-35fd1fe20ff6;FALSE;00°;0;0;0;0;0
e1e7ab81-7518-4e7e-8bfb-d1272197909a;TRUE;00°;0;4;0;4;4
7d47e43d-0f45-4fee-bbf9-2aab9b17f797;TRUE;00°;0;0;0;0;0
545c798e-514b-4fdc-a3e9-e16f9252c036;TRUE;00°;0;0;0;0;0
f5431483-cddf-4f34-a0a2-73e76134f630;TRUE;00°;0;0;0;0;0
c645f2b9-255b-4dc4-bcb6-d21b87b7270f;TRUE;00°;0;0;0;0;0
fba08b0f-5607-49d1-8543-e509087c0330;TRUE;00°;0;0;0;0;0
de0c7388-1a8b-4f3f-a97e-de0f4b5e41d0;TRUE;00°;0;3;0;3;3
409da35c-1143-4f72-8599-3df0675db3fd;TRUE;00°;0;0;0;0;0
79b6f745-f5e3-4fce-bd50-6e96a6a03994;TRUE;00°;0;0;0;0;0
c7bd2e40-86da-4cab-a8e0-669beaa93e0b;TRUE;45°;0;0;0;0;0
bd2ae319-9a42-405d-9a45-64df6f97116d;TRUE;00°;0;0;0;0;0
1f658401-df53-46ae-9f33-55b6b2512591;TRUE;00°;0;0;0;0;0
4d53ee07-9863-4991-bd88-4099bfd01449;TRUE;00°;0;0;0;0;0
3f5e0773-d384-4d63-8326-037e0d3d4eea;TRUE;00°;0;0;0;0;0
9e19d3f9-67d1-4ff0-ad1f-989a2ecf5fc3;TRUE;00°;0;1;0;1;1
a8adcc93-28b7-4736-b225-894d70bc0b1f;TRUE;00°;0;1;0;1;1
1e445768-bb1c-4a2c-b275-6344cc59fe43;TRUE;00°;0;1;0;1;1
5cc61c19-78ba-4b74-89c9-127f0734b557;TRUE;45°;0;1;0;1;1
5504e3d7-fa02-4971-89fa-712bbe839175;TRUE;45°;0;6;0;6;6
f093d575-8fcf-4981-8fe0-99c60d264996;TRUE;45°;0;4;0;4;4
1f539632-09c8-4e34-a654-2556cc540314;TRUE;45°;0;0;0;0;0
6b08da2b-39b8-40e2-b729-3ac8a557fa47;TRUE;00°;0;0;0;0;0
f33ccbbd-5ff3-4c80-88f1-8592f22c655a;TRUE;00°;0;0;0;0;0
f993d219-fa3d-4300-acc0-fb459b38f079;TRUE;00°;0;0;0;0;0
5ebb7973-d420-4496-83f7-e8b6ec72ed20;TRUE;00°;0;0;0;0;0
786a960d-5c53-4397-8499-f6d4b9319de6;TRUE;00°;0;11;0;11;11
0e0ea1c7-e6ef-47ec-9a30-4fcfeaa94fcf;FALSE;00°;0;2;0;2;2
a1bc5173-b872-4732-ae5c-00f33e828a61;TRUE;45°;0;5;0;5;5
2e32bb6a-cb04-4355-96ce-03b1a983ecef;FALSE;00°;0;0;0;0;0
f76d48ad-de19-4df1-8cc7-a75726e98a9e;FALSE;00°;0;0;0;0;0
4e6949e7-9205-4c85-badf-229d6cc96e81;FALSE;00°;0;0;0;0;0
aa51b5f9-d75a-4f16-b1d6-89f1f38f6afb;FALSE;00°;0;0;0;0;0
0a84f911-21ed-45f5-87d9-27c16d31439e;FALSE;00°;0;0;0;0;0
2ff8e510-5849-479b-8f39-46f84123abff;FALSE;00°;0;0;0;0;0
9bf07d07-3a48-4867-a8f6-662ecd038a7c;FALSE;00°;0;0;0;0;0
1034446f-092e-4df7-b79d-24c5c1bf6685;FALSE;00°;0;0;0;0;0
16f6d9a5-2fa6-43e7-838b-2698076278af;FALSE;90°;0;0;0;0;0
5cb2e832-768f-45b3-b50f-6e68cb9f9f29;TRUE;00°;106;0;0;0;106
724d0488-339b-4e91-aec3-fa58357224c9;TRUE;00°;0;0;0;0;0
0f4dc010-451e-4e16-8689-8007c9dc5cb1;FALSE;00°;0;0;0;0;0
857080ab-eb23-4922-a4a7-0624bb13de62;TRUE;00°;0;1;0;1;1
e9e887dc-b23b-4d13-bc89-350b02a8a4cc;TRUE;00°;0;0;0;0;0
1785dee8-4d16-43e4-a5d4-65befc925df6;TRUE;00°;0;0;0;0;0
8d19c6f2-9c65-4747-b5e7-2984f5ed49a1;TRUE;00°;0;0;0;0;0
92457e18-241b-4725-8841-4627478ad06a;TRUE;00°;0;0;0;0;0
bf42390a-4fee-4364-900a-7a70c3e88818;TRUE;00°;0;0;0;0;0
890d061d-fbf1-4f4b-941b-2ea57e65131b;TRUE;00°;0;0;0;0;0
76c343e5-1829-446a-91e0-8a0bdfbce62a;TRUE;45°;0;0;0;0;0
6615b3fe-46ca-4bb1-b3bd-38acdd8013b3;TRUE;45°;0;0;0;0;0
6cf272af-f2bc-4919-b0c5-ba55b972b9dc;TRUE;00°;0;0;0;0;0
173f08c5-6a91-4a80-a5ea-7c23b78adafa;TRUE;00°;0;0;0;0;0
f07649a7-b055-4a5f-9132-f938fe95cf62;TRUE;00°;20;3;1;4;24
9668f6d1-5e77-4bf5-8c15-461ef99b2691;TRUE;00°;87;0;0;0;87
c7ef29a7-5e4e-4346-ba2f-a33d796ce2bc;TRUE;00°;67;0;0;0;67
fd165451-471e-49c3-9933-e91b94f142bf;TRUE;00°;35;2;0;2;37
c37ce59e-47ce-4869-a78d-edf05f4465d7;TRUE;00°;0;0;0;0;0
a6454f46-2389-4636-9722-74c6bbeefe5b;TRUE;00°;0;0;0;0;0
36f53d3b-5b15-4fad-83ad-a6cf80cb67b4;TRUE;00°;0;0;0;0;0
5adb3eb7-8bb4-4c1e-92b7-03d00f7e6de1;TRUE;00°;30;0;0;0;30
1ea6b3e8-92e8-4839-8ae6-bcff38f2539d;TRUE;00°;19;0;0;0;19
3d2a34bd-fb1f-4e51-af5a-8a9efcf5ced0;TRUE;00°;6;0;0;0;6
7f875f72-4d40-4be2-999e-fd48e01eae5c;TRUE;45°;46;0;5;5;51
354580a0-a7cf-4b18-9817-90781545b558;TRUE;45°;20;0;0;0;20
cae973f9-16fe-46dc-b399-936856af8582;TRUE;45°;47;1;0;1;48
ccb7ea22-a82f-4a35-9d5c-f7aafab25c70;TRUE;45°;161;3;5;8;169
f7eb7228-dd62-4ea3-9cd6-38088bfed039;TRUE;45°;41;0;1;1;42
2f833366-78f2-4435-969a-0305bced4a9b;TRUE;45°;54;1;0;1;55
8b4c30f5-c96b-4345-befa-f1c6587bc6b0;TRUE;45°;177;0;2;2;179
e860b1c9-5f69-48c6-8300-74735cab6c76;TRUE;45°;43;0;1;1;44
5662f00d-8bd2-43d1-97ac-c77050a6a070;TRUE;45°;36;1;1;2;38
ab091f02-2beb-49b2-90df-708443304af2;TRUE;45°;19;0;1;1;20
d407b112-869f-497b-ad8a-5ab6611d0f5f;FALSE;45°;47;0;0;0;47
259d5cfa-5e74-41e1-88a2-a70590ac544e;TRUE;45°;69;0;0;0;69
a5ff9d7f-a67b-4e0f-8193-dcaaa7d86af7;TRUE;45°;10;0;0;0;10
80f9ca90-5afa-4f78-a93a-3866ae739e49;TRUE;45°;130;0;0;0;130
e05e3dd8-0c6d-4cba-ba53-01fc6f9f974e;TRUE;45°;75;0;0;0;75
533cf4e4-a8fb-4b34-809f-86a46802a4dc;TRUE;45°;4;0;0;0;4
0a86adaa-0a8f-449a-a157-8ba7c48f09cc;TRUE;45°;49;0;2;2;51
1e98aa97-cf6a-4be4-953e-eb07be7b96b2;TRUE;00°;0;1;0;1;1
011baa9a-18e8-42db-9547-29cd4445ff89;TRUE;45°;13;0;0;0;13
e1876fd1-e991-4032-9958-fc7e27bbb30f;TRUE;00°;10;0;1;1;11
94e942da-6a95-44a1-a0ca-a758ae266c83;TRUE;45°;8;0;1;1;9
5c4420b3-c459-4f1e-93e5-34bffc8094ae;TRUE;00°;72;0;3;3;75
2c7a14c9-e4c8-4e4d-902c-d941c4eb89e7;TRUE;00°;20;0;0;0;20
fbd31585-9e1c-4ef8-95a4-335955ddae9a;TRUE;45°;24;0;1;1;25
bf67fcdf-d77c-4e77-9cb1-13b4163ac662;TRUE;45°;1;0;0;0;1
aa8b9db9-eeb0-44da-a05d-53a1c17998a0;TRUE;45°;12;0;1;1;13
e1884a8d-f24e-4e65-a699-9a0b8b8172ca;TRUE;45°;32;0;2;2;34
6b4ee311-d736-4a31-a9ba-6f039261414e;TRUE;00°;2;0;1;1;3
4f3b1cba-0cef-486d-8392-799c26c233aa;TRUE;45°;37;1;0;1;38
9ed5adb1-d086-4521-a1d8-5cbd2e435450;TRUE;45°;12;1;0;1;13
254a0167-31b0-4208-bc7f-d11c9b24c3c0;TRUE;45°;0;0;0;0;0
17a6a8ec-fa65-427a-8663-4947031396ce;TRUE;45°;386;0;1;1;387
d2193f18-7b75-47ba-9711-58016b8c06ba;TRUE;00°;26;0;0;0;26
8d46aa56-db62-4160-b767-463ff716f261;TRUE;45°;48;0;0;0;48
8701e2d1-4956-4608-981d-c3b938f7cd6b;TRUE;45°;66;0;0;0;66
57e93a29-0129-4d03-bb39-94cf94a67328;TRUE;45°;0;0;0;0;0
1abd7648-ed9a-4103-9a3c-03d10e1ec21f;NA;45°;0;0;0;0;0
cd8ea921-fe97-4f79-8c0e-2965248dba89;TRUE;45°;23;0;0;0;23
afad2798-ad7a-4e07-ab0c-705bc5c3297c;TRUE;45°;20;0;0;0;20
8fac59c4-20d2-4f4b-b7d0-ea078d6d4e7b;TRUE;45°;1;0;0;0;1
18cc60b6-00f1-472a-9bfc-bf257e06e624;TRUE;45°;0;0;1;1;1
a911c8f5-2614-42b9-8643-48fd18cab808;TRUE;45°;7;1;0;1;8
85e10418-9220-4c3a-af69-9e9fcea1a069;TRUE;45°;0;0;0;0;0
09d477da-493a-4f00-aadd-2826dc80c228;TRUE;45°;16;0;0;0;16
54fd74a0-4e6d-4953-af30-5f6f936f9a97;TRUE;45°;54;0;0;0;54
84388f24-dc95-4374-a92b-f991dd19bd34;TRUE;45°;422;4;1;5;427
151f1c07-97f7-4e55-84f4-6d11a0eca58f;TRUE;45°;360;28;2;30;390
c2475fb2-12a2-4896-ac50-73668b20eb33;TRUE;45°;884;85;2;87;971
1846afaa-ec47-41eb-b588-1a7d17e517bf;TRUE;45°;583;5;2;7;590
f39615d2-4861-45cf-9ff9-18ade180fd93;TRUE;00°;0;0;0;0;0
b33081f8-ca1e-4f20-8ba8-e1ece38f3b64;TRUE;00°;0;0;0;0;0
5003be39-1aa9-41f3-9d0b-8a235347819c;TRUE;00°;0;0;0;0;0
babf42c1-4552-43d0-8b96-76b1f699ac22;TRUE;00°;762;0;2;2;764
f67df926-3242-41d0-8b89-73a2f3b6ccf5;TRUE;00°;124;1;2;3;127
b5000acc-721e-44af-bdee-39cdcc2a2b8d;TRUE;45°;72;2;0;2;74
dcca02bd-661f-49ca-94e3-485c859c6fc8;TRUE;00°;29;0;3;3;32
334d0bf5-6217-4b71-b09f-29e898cd4d43;TRUE;00°;0;0;0;0;0
79aaae61-28c1-47b9-85bd-9c04a5bf69e2;TRUE;45°;95;8;0;8;103
69e57d5e-583f-40c2-9c2f-1aa7abcab7a6;TRUE;00°;0;0;0;0;0
38833b38-7912-4579-a380-3b7fcb4fa408;TRUE;00°;0;0;0;0;0
59d9c6db-d425-4036-8c2d-5449cac483e3;TRUE;00°;0;0;0;0;0
c98e4fd8-d511-447a-bedf-1bd60cbba181;TRUE;00°;0;0;1;1;1
51f194ea-4243-493b-8582-7089fa733f97;TRUE;00°;0;0;0;0;0
77030965-00fa-47c5-9425-0217c2caa97f;TRUE;00°;0;0;0;0;0
469972e8-ecde-4136-811b-1b5c4db9aa7b;TRUE;00°;0;0;1;1;1
ecb8e09e-7496-4024-91ec-ace91d8183e7;TRUE;00°;0;0;0;0;0
c6788015-ddf8-4b04-b2a0-8655fcbceb4d;TRUE;00°;0;1;0;1;1
964ecb87-ddb8-4316-b6f8-eadb01de98ef;TRUE;00°;0;0;0;0;0
d49311ee-95e5-430f-a88f-bbafeabd28ff;TRUE;00°;0;0;0;0;0
acdb92e8-f964-4178-afb4-74156f325159;TRUE;45°;0;0;0;0;0
3d240393-383d-47fc-857a-dad4886cce8e;TRUE;45°;0;0;0;0;0
3d3d84fd-728e-47c9-914d-da97ec3b99aa;TRUE;00°;0;0;0;0;0
1093a6cc-3ed9-4912-b5a2-23ab13cb56ca;TRUE;00°;0;0;0;0;0
7131411c-ba46-4788-af91-020f742a2925;TRUE;00°;0;0;0;0;0
c04fab4e-b599-4b8c-829d-e790306a2743;TRUE;00°;0;0;0;0;0
9394bb43-8168-45bc-99a2-761320330fd5;TRUE;00°;0;0;0;0;0
cd2b1bc1-ebdf-4c65-8504-b3350ef64137;TRUE;00°;0;0;0;0;0
0888e4b1-e5d4-4b2c-ac16-0382a5bdf864;FALSE;00°;269;40;0;40;309
cb77f7b5-ccee-4fe2-a072-21ba7f7a983f;FALSE;45°;0;0;0;0;0
dd5d23e7-0510-4f55-a22a-47a2104830bb;FALSE;45°;0;0;0;0;0
75a3d771-5a2d-46df-bbdc-d4ae110ad410;FALSE;45°;0;0;0;0;0
fd73511f-730c-4685-92d0-ceaf3b986fc5;FALSE;45°;0;0;0;0;0
911a7b1f-41fa-4827-a2b7-7d4f6a3e2192;TRUE;00°;1;9;0;9;10
bba2543a-8c11-4410-a9c5-b5bd22e0b4a5;TRUE;00°;0;2;0;2;2
98008afc-db9d-41f4-9666-d9f3e1cc6563;FALSE;00°;0;0;0;0;0
d7057ed7-83fd-4774-9245-35fd1fe20ff6;FALSE;00°;0;0;0;0;0
de0c7388-1a8b-4f3f-a97e-de0f4b5e41d0;TRUE;00°;0;5;0;5;5
409da35c-1143-4f72-8599-3df0675db3fd;TRUE;00°;0;1;0;1;1
c7bd2e40-86da-4cab-a8e0-669beaa93e0b;TRUE;00°;0;2;0;2;2
9e19d3f9-67d1-4ff0-ad1f-989a2ecf5fc3;TRUE;00°;0;1;0;1;1
1e445768-bb1c-4a2c-b275-6344cc59fe43;TRUE;00°;0;2;0;2;2
5cc61c19-78ba-4b74-89c9-127f0734b557;TRUE;45°;0;1;0;1;1
5504e3d7-fa02-4971-89fa-712bbe839175;TRUE;45°;0;5;0;5;5
1f539632-09c8-4e34-a654-2556cc540314;TRUE;45°;0;3;0;3;3
786a960d-5c53-4397-8499-f6d4b9319de6;TRUE;00°;0;19;0;19;19
0e0ea1c7-e6ef-47ec-9a30-4fcfeaa94fcf;FALSE;00°;0;1;0;1;1
2e32bb6a-cb04-4355-96ce-03b1a983ecef;FALSE;00°;0;0;0;0;0
f76d48ad-de19-4df1-8cc7-a75726e98a9e;FALSE;00°;0;0;0;0;0
4e6949e7-9205-4c85-badf-229d6cc96e81;FALSE;00°;0;0;0;0;0
aa51b5f9-d75a-4f16-b1d6-89f1f38f6afb;FALSE;00°;0;0;0;0;0
0a84f911-21ed-45f5-87d9-27c16d31439e;FALSE;00°;0;0;0;0;0
2ff8e510-5849-479b-8f39-46f84123abff;FALSE;00°;0;0;0;0;0
9bf07d07-3a48-4867-a8f6-662ecd038a7c;FALSE;00°;0;0;0;0;0
1034446f-092e-4df7-b79d-24c5c1bf6685;FALSE;00°;0;0;0;0;0
16f6d9a5-2fa6-43e7-838b-2698076278af;FALSE;00°;0;0;0;0;0
5cb2e832-768f-45b3-b50f-6e68cb9f9f29;TRUE;00°;16;0;0;0;16
f07649a7-b055-4a5f-9132-f938fe95cf62;TRUE;00°;0;9;0;9;9
9668f6d1-5e77-4bf5-8c15-461ef99b2691;TRUE;00°;19;0;0;0;19
c7ef29a7-5e4e-4346-ba2f-a33d796ce2bc;TRUE;00°;28;0;0;0;28
fd165451-471e-49c3-9933-e91b94f142bf;TRUE;00°;0;2;0;2;2
c37ce59e-47ce-4869-a78d-edf05f4465d7;TRUE;00°;0;0;0;0;0
a6454f46-2389-4636-9722-74c6bbeefe5b;TRUE;00°;0;0;0;0;0
36f53d3b-5b15-4fad-83ad-a6cf80cb67b4;TRUE;00°;0;0;0;0;0
5adb3eb7-8bb4-4c1e-92b7-03d00f7e6de1;TRUE;00°;10;0;0;0;10
1ea6b3e8-92e8-4839-8ae6-bcff38f2539d;TRUE;00°;26;0;0;0;26
3d2a34bd-fb1f-4e51-af5a-8a9efcf5ced0;TRUE;00°;6;1;0;1;7
354580a0-a7cf-4b18-9817-90781545b558;TRUE;45°;30;0;1;1;31
cae973f9-16fe-46dc-b399-936856af8582;TRUE;45°;11;1;0;1;12
f7eb7228-dd62-4ea3-9cd6-38088bfed039;TRUE;45°;18;0;2;2;20
2f833366-78f2-4435-969a-0305bced4a9b;TRUE;45°;32;1;0;1;33
8b4c30f5-c96b-4345-befa-f1c6587bc6b0;TRUE;45°;51;1;3;4;55
e860b1c9-5f69-48c6-8300-74735cab6c76;TRUE;45°;20;0;1;1;21
5662f00d-8bd2-43d1-97ac-c77050a6a070;TRUE;45°;10;0;0;0;10
ab091f02-2beb-49b2-90df-708443304af2;TRUE;45°;9;0;0;0;9
d407b112-869f-497b-ad8a-5ab6611d0f5f;FALSE;45°;47;0;0;0;47
a5ff9d7f-a67b-4e0f-8193-dcaaa7d86af7;TRUE;45°;6;0;0;0;6
80f9ca90-5afa-4f78-a93a-3866ae739e49;TRUE;45°;91;0;0;0;91
533cf4e4-a8fb-4b34-809f-86a46802a4dc;TRUE;45°;1;0;0;0;1
0a86adaa-0a8f-449a-a157-8ba7c48f09cc;TRUE;45°;50;0;0;0;50
1e98aa97-cf6a-4be4-953e-eb07be7b96b2;TRUE;00°;28;0;0;0;28
011baa9a-18e8-42db-9547-29cd4445ff89;TRUE;00°;34;2;0;2;36
94e942da-6a95-44a1-a0ca-a758ae266c83;TRUE;45°;2;0;0;0;2
fbd31585-9e1c-4ef8-95a4-335955ddae9a;TRUE;45°;46;0;0;0;46
aa8b9db9-eeb0-44da-a05d-53a1c17998a0;TRUE;45°;7;0;0;0;7
e1884a8d-f24e-4e65-a699-9a0b8b8172ca;TRUE;00°;152;0;0;0;152
4f3b1cba-0cef-486d-8392-799c26c233aa;TRUE;45°;86;1;0;1;87
254a0167-31b0-4208-bc7f-d11c9b24c3c0;TRUE;45°;11;0;0;0;11
17a6a8ec-fa65-427a-8663-4947031396ce;TRUE;00°;77;0;3;3;80
8d46aa56-db62-4160-b767-463ff716f261;TRUE;45°;82;0;0;0;82
57e93a29-0129-4d03-bb39-94cf94a67328;TRUE;45°;0;0;0;0;0
1abd7648-ed9a-4103-9a3c-03d10e1ec21f;NA;45°;1;0;0;0;1
84388f24-dc95-4374-a92b-f991dd19bd34;TRUE;45°;464;2;0;2;466
1846afaa-ec47-41eb-b588-1a7d17e517bf;TRUE;45°;1453;1;1;2;1455
f39615d2-4861-45cf-9ff9-18ade180fd93;TRUE;00°;0;0;0;0;0
b33081f8-ca1e-4f20-8ba8-e1ece38f3b64;TRUE;00°;0;0;0;0;0
5003be39-1aa9-41f3-9d0b-8a235347819c;TRUE;00°;0;0;0;0;0
babf42c1-4552-43d0-8b96-76b1f699ac22;TRUE;45°;299;2;0;2;301
f67df926-3242-41d0-8b89-73a2f3b6ccf5;TRUE;00°;500;1;3;4;504
b5000acc-721e-44af-bdee-39cdcc2a2b8d;TRUE;00°;178;4;0;4;182
dcca02bd-661f-49ca-94e3-485c859c6fc8;TRUE;00°;371;0;2;2;373
334d0bf5-6217-4b71-b09f-29e898cd4d43;TRUE;00°;0;0;0;0;0
79aaae61-28c1-47b9-85bd-9c04a5bf69e2;TRUE;00°;103;1;0;1;104
51f194ea-4243-493b-8582-7089fa733f97;TRUE;00°;0;0;0;0;0
964ecb87-ddb8-4316-b6f8-eadb01de98ef;TRUE;00°;0;0;0;0;0
d49311ee-95e5-430f-a88f-bbafeabd28ff;TRUE;00°;0;0;0;0;0
acdb92e8-f964-4178-afb4-74156f325159;TRUE;45°;0;0;0;0;0
3d240393-383d-47fc-857a-dad4886cce8e;TRUE;00°;0;0;0;0;0
3d3d84fd-728e-47c9-914d-da97ec3b99aa;TRUE;00°;0;0;0;0;0
1093a6cc-3ed9-4912-b5a2-23ab13cb56ca;TRUE;00°;0;0;0;0;0
7131411c-ba46-4788-af91-020f742a2925;TRUE;00°;0;0;0;0;0
c04fab4e-b599-4b8c-829d-e790306a2743;TRUE;00°;0;0;0;0;0
9394bb43-8168-45bc-99a2-761320330fd5;TRUE;00°;0;0;0;0;0
cd2b1bc1-ebdf-4c65-8504-b3350ef64137;TRUE;00°;0;0;0;0;0
cb77f7b5-ccee-4fe2-a072-21ba7f7a983f;FALSE;45°;0;0;0;0;0
dd5d23e7-0510-4f55-a22a-47a2104830bb;FALSE;45°;0;2;0;2;2
75a3d771-5a2d-46df-bbdc-d4ae110ad410;FALSE;45°;0;0;0;0;0
fd73511f-730c-4685-92d0-ceaf3b986fc5;FALSE;45°;0;0;0;0;0
911a7b1f-41fa-4827-a2b7-7d4f6a3e2192;TRUE;00°;0;5;0;5;5
bba2543a-8c11-4410-a9c5-b5bd22e0b4a5;TRUE;00°;0;1;0;1;1
98008afc-db9d-41f4-9666-d9f3e1cc6563;FALSE;00°;0;0;0;0;0
d7057ed7-83fd-4774-9245-35fd1fe20ff6;FALSE;00°;0;0;0;0;0
de0c7388-1a8b-4f3f-a97e-de0f4b5e41d0;TRUE;00°;0;5;0;5;5
409da35c-1143-4f72-8599-3df0675db3fd;TRUE;00°;0;0;0;0;0
1e445768-bb1c-4a2c-b275-6344cc59fe43;TRUE;00°;0;8;0;8;8
5cc61c19-78ba-4b74-89c9-127f0734b557;TRUE;45°;0;1;0;1;1
5504e3d7-fa02-4971-89fa-712bbe839175;TRUE;45°;0;9;0;9;9
1f539632-09c8-4e34-a654-2556cc540314;TRUE;45°;0;1;0;1;1
786a960d-5c53-4397-8499-f6d4b9319de6;TRUE;00°;0;14;0;14;14
0e0ea1c7-e6ef-47ec-9a30-4fcfeaa94fcf;FALSE;00°;0;2;2;4;4
2e32bb6a-cb04-4355-96ce-03b1a983ecef;FALSE;00°;0;0;0;0;0
f76d48ad-de19-4df1-8cc7-a75726e98a9e;FALSE;00°;0;0;0;0;0
4e6949e7-9205-4c85-badf-229d6cc96e81;FALSE;00°;0;0;0;0;0
aa51b5f9-d75a-4f16-b1d6-89f1f38f6afb;FALSE;00°;0;0;0;0;0
0a84f911-21ed-45f5-87d9-27c16d31439e;FALSE;00°;0;0;0;0;0
2ff8e510-5849-479b-8f39-46f84123abff;FALSE;00°;0;0;0;0;0
9bf07d07-3a48-4867-a8f6-662ecd038a7c;FALSE;00°;0;0;0;0;0
1034446f-092e-4df7-b79d-24c5c1bf6685;FALSE;00°;0;0;0;0;0
16f6d9a5-2fa6-43e7-838b-2698076278af;FALSE;90°;0;0;0;0;0
5cb2e832-768f-45b3-b50f-6e68cb9f9f29;TRUE;00°;65;0;0;0;65
fd165451-471e-49c3-9933-e91b94f142bf;TRUE;00°;25;1;0;1;26
c37ce59e-47ce-4869-a78d-edf05f4465d7;TRUE;00°;0;0;0;0;0
a6454f46-2389-4636-9722-74c6bbeefe5b;TRUE;00°;0;0;0;0;0
5adb3eb7-8bb4-4c1e-92b7-03d00f7e6de1;TRUE;00°;20;0;0;0;20
3d2a34bd-fb1f-4e51-af5a-8a9efcf5ced0;TRUE;00°;48;0;0;0;48
354580a0-a7cf-4b18-9817-90781545b558;TRUE;45°;2;0;0;0;2
cae973f9-16fe-46dc-b399-936856af8582;TRUE;45°;29;0;0;0;29
f7eb7228-dd62-4ea3-9cd6-38088bfed039;TRUE;45°;59;0;3;3;62
2f833366-78f2-4435-969a-0305bced4a9b;TRUE;45°;1;0;0;0;1
5662f00d-8bd2-43d1-97ac-c77050a6a070;TRUE;45°;87;0;0;0;87
d407b112-869f-497b-ad8a-5ab6611d0f5f;FALSE;45°;25;1;1;2;27
80f9ca90-5afa-4f78-a93a-3866ae739e49;TRUE;45°;169;1;0;1;170
0a86adaa-0a8f-449a-a157-8ba7c48f09cc;TRUE;45°;160;1;1;2;162
1abd7648-ed9a-4103-9a3c-03d10e1ec21f;NA;45°;0;0;0;0;0
84388f24-dc95-4374-a92b-f991dd19bd34;TRUE;45°;401;2;1;3;404
1846afaa-ec47-41eb-b588-1a7d17e517bf;TRUE;45°;311;3;0;3;314
f39615d2-4861-45cf-9ff9-18ade180fd93;TRUE;00°;0;0;0;0;0
5003be39-1aa9-41f3-9d0b-8a235347819c;TRUE;00°;0;0;0;0;0
d49311ee-95e5-430f-a88f-bbafeabd28ff;TRUE;00°;0;0;0;0;0
3d240393-383d-47fc-857a-dad4886cce8e;TRUE;00°;0;0;0;0;0
1093a6cc-3ed9-4912-b5a2-23ab13cb56ca;TRUE;00°;0;0;0;0;0
c04fab4e-b599-4b8c-829d-e790306a2743;TRUE;00°;0;0;0;0;0
98008afc-db9d-41f4-9666-d9f3e1cc6563;FALSE;00°;0;0;0;0;0
d7057ed7-83fd-4774-9245-35fd1fe20ff6;FALSE;00°;0;0;0;0;0
5cc61c19-78ba-4b74-89c9-127f0734b557;TRUE;45°;0;3;0;3;3
1f539632-09c8-4e34-a654-2556cc540314;TRUE;45°;0;1;0;1;1
0e0ea1c7-e6ef-47ec-9a30-4fcfeaa94fcf;FALSE;00°;0;1;0;1;1
354580a0-a7cf-4b18-9817-90781545b558;TRUE;00°;173;0;0;0;173
d407b112-869f-497b-ad8a-5ab6611d0f5f;FALSE;45°;34;1;1;2;36
80f9ca90-5afa-4f78-a93a-3866ae739e49;TRUE;45°;27;1;0;1;28
0a86adaa-0a8f-449a-a157-8ba7c48f09cc;TRUE;45°;21;1;0;1;22
84388f24-dc95-4374-a92b-f991dd19bd34;TRUE;45°;404;1;0;1;405
1846afaa-ec47-41eb-b588-1a7d17e517bf;TRUE;45°;414;1;1;2;416
f39615d2-4861-45cf-9ff9-18ade180fd93;TRUE;00°;0;0;0;0;0
d49311ee-95e5-430f-a88f-bbafeabd28ff;TRUE;00°;0;0;0;0;0
3d240393-383d-47fc-857a-dad4886cce8e;TRUE;00°;0;0;0;0;0
1093a6cc-3ed9-4912-b5a2-23ab13cb56ca;TRUE;00°;0;0;0;0;0
c04fab4e-b599-4b8c-829d-e790306a2743;TRUE;00°;0;0;0;0;0
98008afc-db9d-41f4-9666-d9f3e1cc6563;FALSE;45°;0;0;0;0;0
d7057ed7-83fd-4774-9245-35fd1fe20ff6;FALSE;00°;0;0;0;0;0
f39615d2-4861-45cf-9ff9-18ade180fd93;TRUE;00°;0;0;0;0;0
d49311ee-95e5-430f-a88f-bbafeabd28ff;TRUE;00°;0;0;0;0;0
3d240393-383d-47fc-857a-dad4886cce8e;TRUE;00°;0;0;0;0;0
1093a6cc-3ed9-4912-b5a2-23ab13cb56ca;TRUE;00°;0;0;0;0;0
c04fab4e-b599-4b8c-829d-e790306a2743;TRUE;00°;0;0;0;0;0
98008afc-db9d-41f4-9666-d9f3e1cc6563;FALSE;45°;0;0;0;0;0
d7057ed7-83fd-4774-9245-35fd1fe20ff6;FALSE;00°;0;0;0;0;0
f39615d2-4861-45cf-9ff9-18ade180fd93;TRUE;00°;0;0;0;0;0
d49311ee-95e5-430f-a88f-bbafeabd28ff;TRUE;00°;0;0;0;0;0
3d240393-383d-47fc-857a-dad4886cce8e;TRUE;00°;0;0;0;0;0
c04fab4e-b599-4b8c-829d-e790306a2743;TRUE;00°;0;0;0;0;0
98008afc-db9d-41f4-9666-d9f3e1cc6563;FALSE;45°;0;0;0;0;0
d7057ed7-83fd-4774-9245-35fd1fe20ff6;FALSE;00°;0;0;0;0;0
98008afc-db9d-41f4-9666-d9f3e1cc6563;FALSE;00°;0;0;0;0;0
d7057ed7-83fd-4774-9245-35fd1fe20ff6;FALSE;00°;0;0;0;0;0
98008afc-db9d-41f4-9666-d9f3e1cc6563;FALSE;00°;0;0;0;0;0
d7057ed7-83fd-4774-9245-35fd1fe20ff6;FALSE;00°;0;0;0;0;0
98008afc-db9d-41f4-9666-d9f3e1cc6563;FALSE;00°;0;0;0;0;0
d7057ed7-83fd-4774-9245-35fd1fe20ff6;FALSE;00°;0;0;0;0;0
98008afc-db9d-41f4-9666-d9f3e1cc6563;FALSE;00°;0;0;0;0;0
d7057ed7-83fd-4774-9245-35fd1fe20ff6;FALSE;00°;0;0;0;0;0
